11111111111111111111
1C000100010000000111
10000000000000000111
11110000000000000001
1P0000000100000001E1
11110000010000000001
1000000000000C00011
11111111111111111111
