11111111111
10000000101
10000000101
10000001011
100C0000011
10C0P000101
1000E000101
10000000101
11111111111
